hospitality - goscinnosc
eventually - ostatecznie
snag - szkopuł
straggling - marudzic
neglect - zaniedbać
scorn - pogarda
praise - pochwala
crufty - badly designed
lousy - parszywy
unambigious - niedwuznaczny
bias - stronniczość
eagerly - z zapalem
sentinel - strażnik
proxy - pelnomocnik
vanity - bezcelowy
'Eat Your Own Dog Food' - A colloquialism that describes a company using its own products or services for its internal operations.
ingestion - zbieranie danych
opaque - nieprzeźroczysty
purge - oczyścić
vividly - żywy, dziarski
indices - liczba mnoga od index
nauseous - nudny
cork - korek
prick - kutas
overindulge - have too much of something enjoyable, especially food or drink
estate - majątek
raffle - loteria
tremendously - ogromnie
rectify - prostować
clunky - przylegający
phony - fałszywy
haggle - targować się
eke out - uzupełniać się
lessee - dzierżawca
rentee - najemca
tow - holować
flaky - łuskowaty
pick up stakes - podnieść stawkę
cite - cytować
vital - istotny
smart aleck - a person who is irritating because they behave as if they know everything.
robust - silny, krzepki
syllabus - konspekt
cobble together - sklecić
virtue - cnota
stitch - szew
incorporate - włączać
slight - niewielki
inclined - skłonny
nebulous - mglisty
acumen - bystrość
mere - sam/zwykły
commission - komisja
cease - zaprzestać
standstill - zastój
gig - bieda
amiss - źle
ensue - wynikać
nifty - ładnie
tuition - czesne
dime - moneta dziesięciocentowa
sulking - dąsać
discouraged - zniechęcony
begets - wywoływać
kudos - sława
retaliation - odwet
crucial - istotny
vague - niejasny
albeit - aczkolwiek
farewell - pożegnanie
hitherto - dotychczas
cumbersome - niewygodny
vast swaths - ogromne połacie